A delicious apple / banana / orange.	美味的蘋果/ 香蕉/ 橙子。
Are you full?	飽了嗎？
Are you OK? Yes, I am.	你還好嗎？我挺好的。
Are you ready?	準備好了嗎？
Are you thirsty? / Are you hungry?	你渴嗎？ / 你餓嗎？
Are you tired? / Let's take a rest.	你累了嗎？ / 讓我們休息一下。
Are you sure?	你確定嗎?
As soon as possible.	儘快!
Absolutely not.	絕對不是.
Attention.	注意。
Be careful.	小心。
Be quiet. / Keep quiet.	保持安靜。
Boys, go to the restroom first, please.	男孩先去洗手間。
Brush your teeth.	刷牙。
Believe me.	相信我.
Bye-bye mom / daddy.	再見媽媽/ 爸爸。
Can I go to restroom?	我能上廁所嗎?
Can I help you?	我能幫你嗎？
Can you speak slowly?	請您說慢一點好嗎?
Check it out.	檢查完善。
Clap your hands.	拍手。
Close the door.	關門。
Close your eyes / mouth.	閉上你的眼睛。 / 合上你的嘴巴。
Comb your hair.	梳頭。
Come down.	冷靜。
Come here. / Come on.	過來。
Come in, please.	請進。
Come on guys.	男孩們過來。
Come on. / come here, please.	請過來。
Call me tomorrow.	明天打電話給我.
Congratulations.	恭喜!
Count off	報數。
Dink some water / tea / milk.	喝點水/ 茶/ 牛奶。
Do I need to put my toys in order?	我要把玩具收好嗎？
Do you know?	你知道嗎?
Do you want to more?	你要加一些嗎？
Don't be afraid / shy.	別害怕 / 害羞。
Don't be afraid, and it's safe.	別害怕，它是安全的。
Don't cry, I will play with you.	別哭，我和你一起玩。
Don't move.	別動。
Don't play with your foods.	別玩食物。
Don't push me.	別推我。
Don't do it.	不要這樣做.
Don't spill your foods on the table.	別把你的食物灑在桌子上。
Don't talk.	不要說話。
Don't worry.	別擔心。
Dress yourself.	自己穿衣服
Dry your hands with your towel.	用毛巾把手擦乾。
Easy!	放鬆！
Eat some more.	再多吃一點。
Enjoy yourself.	自娛自樂。
Excuse me!	打擾一下！
Excuse me, what is your name?	打擾一下，你叫什?名字？
Excuse me. Can you do my shoes?	打擾一下，你能幫我把鞋子弄好嗎？
Fall in. / Fall out.	集合。 / 解散。
Fold up your clothes / coat / trousers / shoes.	疊好衣服/ 外套/ 褲子，放好鞋。
Fold up your quilt.	疊被子。
Follow me.	跟著我。
Get up.	起來。
Go ahead.	繼續。
Go straight, and turn left / right.	一直走，左轉/ 右轉。
Go to sleep.	睡覺。
Go to there.	去那邊。
Good afternoon!	午安!
Good bye.	再見
Good morning.	早安。
Give me a hand.	幫我一下.
Good-bye	再見。
Great! / Good! / OK!	好。
Happy birthday!	生日快樂！
Happy New Year!	新年快樂！
Happy New Year！	我祝你新年快樂！
Have an apple.	有一個蘋果。
Have a good trip.	祝一路順風.
He snatches my toys/ books.	他搶我的玩具/ 書。
Hello, can I talk with Mr.Davy please?	你好，我能和大為先生談談嗎？
Hello, nice to meet you. / Nice to see you.	你好，見到你真高興。
Help! Help!	救命！救命！
Here Am I.	我在這裡。
Here you are.	給你。
He's hitting me！	他打我！
Hi! / Hello!	你好！
How are you? I am fine, thank you.	你好嗎？我很好，謝謝。
How beautiful your clothes are!	你的衣服是多?的漂亮呀！
How beautiful!	多美呀！
How do you know?	你怎麼知道的？
How far are the bank / hospital?	銀行/ 醫院裡這裡有多遠？
How funny!	多有趣呀！/真奇怪呢!
How old are you? I am (four).	你幾歲了？我（四）歲。
Hurry up.	快點。
I am busy now, see you later.	我很忙現在，一會兒見。
I am cold / hot / warm.	我覺得冷/ 熱/ 暖和。
I am cool.	我很酷。
I am down.	我做完了。
I am full.	我吃飽了。
I am happy / angry / sad.	我高興/ 生氣/ 沮喪。
I am hungry.	我餓了。
I am short.	我長的矮。
I am sorry.	對不起。
I am tall.	我長得高。
I am the first!	我是第一名!
I am the winner!	我是勝利者！
I am under the weather.	我不舒服。
I am wasting my time.	我在浪費時間.
I don't like it.	我不喜歡.
I bring my VCD.	我帶碟了
I can sing / dance / fly / jump.	我會唱歌/ 跳舞/ 飛/ 蹦。
I can’t see.	我看不見。
I can't write my name.	我不會寫我的名字。
I don’t know.	我不知道。
I got a headache.	有點頭痛.
I got cold.	我感冒了。
I have a book / bird / dog.	我有一本書/鳥/狗.
I have a cough.	我咳嗽。
I have a toothache.	我牙疼。
I have no paper.	我沒有紙。
I like fish / beef / lamb.	我喜歡魚肉/ 牛肉/ 羊肉。
I like orange-juice.	我喜歡桔子汁
I like toys.	我喜歡玩玩具。
I love you！	我愛你！
I miss my Mummy.	我想我媽媽。
I need some money to buy a car.	我需要錢買一輛車。
I spilled my soup.	我把湯撒了。
I want more rice / vegetable.	我還要米飯/ 菜。
I want to go to the playground.	我想要出去外面玩!。
I want to go to the toilet.	我想上廁所。
I want to play with Davy.	我想和Davy玩。
I was sick yesterday.	我昨天病了。
I washed my hands.	我洗過手了。
I'm better today.	我今天好了。
I'm the helper.	我是小幫手。
I'm bored.	我很無聊.
I'm used to it.	我習慣囉.
I'll try.	我會試看看.
It doesn't matter.	沒關係的.
It's incredible!	真是難以置信.
It's nothing.	沒什麼.
It's time to go.	讓走了囉.
It's different.	那是不同的.
It's not bad.	還不錯.
It's not difficult.	那不難啊.
It's not worth it.	不值得.
It's your turn.	輪到你囉.
Is it delicious?	它好吃嗎？
Is it your book / chair / table?	它是你的書/ 椅子/ 桌子嗎？
Is that clear? / Do you understand?	清楚了麼？你明白嗎？
Is this a flower / cat / cow?	這是一枝花嗎？ / 一隻貓嗎？ / 一隻牛嗎？
It's a nice day!	這是一個很好的一天！
It's a sunny / cloudy day!	是個晴天/ 陰天。
It's bed time.	午睡時間到了。
It's cold / hot.	天氣冷 / 熱。
It's raining.	下雨了。
It's time for lunch.	午飯時間到了。
It's time for morning exercises.	早操時間到了。
It's warm here.	這裡很暖。
I would like a cup of coffee,please.	請給我一杯咖啡.
Keep away.	離遠點。
Keep in Touch.	保持聯繫。
Keep quite.	保持安靜。
Leave me along. / don't bother me.	離我遠點。 / 別煩我。
Let me try.	讓我來試試。
Let's dancing / sing.	讓我們來跳舞唱歌。
Let's go back to the classroom.	讓我們回教室。
Let's go downstairs.	讓我們到樓下去。
Let's go out / outside.	讓我們到室外去。
Let's go out for a walk.	讓我們出去走走。
Let's go to sleep. / Let's go to bed.	讓我們去睡覺。
Let's go.	讓我們走。
Let's have a race.	讓我們來個比賽。
Let's listen to a story.	讓我們聽個故事。
Let's play a game.	讓我們來玩遊戲。
Let's play house.	我們玩娃娃家吧。
Let's play on the ground.	讓我們去操場上玩。
Let's play together.	讓我們一起玩。
Let's say it together.	讓我們一起說。
Let's start / begin.	讓我們開始。
Let's start.	讓我們開始。
Let's watch TV / a play.	讓我們看電視/ 看表演。
Let's write / draw something.	讓我們來寫點什麼/ 畫點什麼。
Line up.	排隊。
Listen carefully.	仔細聽。
Listen to me.	聽我說。
Listen to the music.	聽音樂。
Look at me.	看著我。
Look at the blackboard.	看黑板。
Look out.	當心。
Me too.	我也是.
Make a circle.	圍一個圈。
May I come in? Come in please.	我能進來嗎？請進。
Merry Christmas!	聖誕快樂！
Miss Lee, you are very beautiful！	李老師你真漂亮！
My dear mother / father.	我親愛的媽媽/ 爸爸。
Not yet.	還沒有.
Never mind.	沒關係。
Nice girl / boy.	好女孩 / 男孩。
Oh, my god / goodness!	哦，我的上帝！
OK，Stop!	好了，停！
One by one.	一個接著一個。
Open / close your book, please.	打開/ 合上你的書。
Open the door.	開門。
Open your eyes / mouth.	睜開你的眼睛。 / 張開你的嘴巴。
Paint it in red.	把它塗成紅色。
Pardon.	重說一邊。
Pick it up.	把它撿起來。
Pick me up early.	早點接我
Please carry your morning check- card.	請把檢查卡帶好。
Please eat some snack.	請吃些午點。
Please keep the table clean.	請保持桌面乾淨。
Please make it down.	請把XXX結束。
Please say bye-bye to your mom / daddy.	請和媽媽/爸爸說再見。
Please take your cup.	請拿你的杯子嘿。
Put hands into the quilt.	把手放進被子裡。
Put on your clothes.	穿衣服。
Put on your coat.	穿上你的外套。
Put your hands on your knees.	把手放在膝蓋上。
Raise your hand.	舉手。
Raise your hands. / Hands down.	把手舉起來/ 把手放下。
Read it with me.	和我一起讀。
Really?	真的？
Return to your seat.	回去你的座位上。
Rinse out your mouth.	漱口。
Run!	跑!
Say it in English.	用英語說。
See you next week.	下週見。
See you tomorrow? See you tomorrow.	明天見？明天見。
Show me.	給我看。
Sing a song.	唱首歌。
Sit well. / Sit nicely.	坐好。
Slow down, and take it easy.	慢點， 別著急。
Softly.	輕輕的。
Stand up. / Sit down.	起立 / 坐下。
Stop running!	別跑。
Stop talking.	別說話。
Stop!	停!
Sure, no problem.	當然，沒問題。
Take a rest.	休息。
Take off your clothes / coat / trousers / shoes.	脫衣服/ 外套/ 褲子/ 鞋。
Taste good.	好好吃。
Teacher, he pushes me.	老師，他推我。
Thank you very much!	非常感謝你！
That's a good idea.	它是一個好主意。
There is no tissue paper.	沒有餐巾紙了。
Touch your stomach.	摸摸你的肚子。
Tuck your shirt into your pants.	把衣服掖進褲子裡。
Tuck yourself in well.	蓋好被子。
Turn the tap off after washing your hands.	洗完手後，把水龍頭關了。
Two line.	排二條路。
That's enough.	夠了.
Very nice!	非常好！
Wait a minute.	等一下。
Wait a while.	等一會兒。
Wait for me.	等等我。
Waiting for a while.	稍微等一會兒。
Wake up. / get up.	叫醒。 / 起來。
Wash your face.	洗臉。
Wash your hands with soap.	用香皂洗手。
Watch out!	危險！小心！
Wave your fingers.	擺動你的手指。
We want to play hide and seek.	我們想玩捉迷藏。
What a mess!	太亂了！
What are you doing?	你在做什麼?
What did you hear?	你聽到什麼了？
What is this? This is a table	這是什麼？這是一張桌子。
What is your name? My name is (Alice)	你叫什麼名字？我叫（愛麗絲）。
What kind of juice?	什麼果汁?
What shall we draw today?	我們今天畫什麼。
What time is it?	幾點了？
What time is it? It is (five o'clock).	幾點了？ （五）點了。
What's for lunch / breakfast / supper?	中午/ 早晨/ 晚上吃什麼？
What's that?	那是什麼？
What's wrong with you? Nothing!	你怎麼了？沒事。
What's wrong?	怎麼了？
Where are you going?	你要去哪裡？
Where is my book? Here It is.	我的書在哪裡？它在這裡。
Where is the restaurant?	餐廳在哪裡？
Which one do you like?	你喜歡哪一個？
Who can tell me? / Who can answer me?	誰能告訴我？誰能回答？
Who has down?	誰做完了？
Who is this? This is me.	是誰呀？是我。(電話中)
Who want to try?	誰想試試？
Why are you upset?	為什麼你不高興了？
Wipe your mouth.	擦嘴。
Wonderful! / Great!	太棒了！
Would you like some rice or soup?	你想要一些米飯還是湯？
Wow! It's so nice / lovely!	哇！它太棒了 / 太可愛了！
Yes, it is. / No, it isn't.	是的，它是。 / 不，它不是。
You are beautiful!	你真漂亮！
You are clever!	你真聰明！
You are fast.	你很快。
You are fat.	你胖。
You are good!	你真棒！
You are right.	你是正確的。
You are slow.	你太慢了。
You are so good!	你真棒！
You are so sweet.	你是非常可愛的。
You are the first.	你是第一名。
You are the winner.	你是勝利者。
You are very clever!	你真聰明！
You are welcome.	別客氣。
You look very smart.	你看起來非常聰明。
